NO /window10.dos
SO /ls
WE ./asset/set4/east.xpm
EA ./asset/set4/east.xpm

F 5,15,5
C 20,40,75

1111111111111111111111111
1000000000000010000000001
1100111111000000000111111
1000001  1010000000100001  11111111
1000001  10100000000000011110000111
1000001  10001111100000000000000111
1111001  10000000000011111110000111
1000001  1000101010000001 1110000111
1100001  1000000000000001   1110000111
1101001  1000101010000001    1110000111
1101111  1111000001111111     1110000111
1001        1100001111111       11100001111
1001         110001111111         111000001111
1001         111001111111           11110000011
1001          11101111111              1110000011
1001            101                    1110000011
1001       1111 101                   1110000011
10011111111100111011111111111111111111111000001111111111
1000000000000000000000000000000000000000000N000000000011
11111111111111111111111111111111111111111111111111111111