1111111111111111111111111111111111
1C0000X00000000C00000C00000X000001
1010010100100X00101001000000010101
1010010010101010001001000000010101
1P0000000C00C000E00000X000000000C1
1111111111111111111111111111111111
