1111111111111111111111111111111111
1E0000000000000C00000C000000000001
1000010100100000101001000000101001
1000000000000000000000000000000001
1000010010101011001001001000101001
1P0000010C00C000000000000011000C01
1111111111111111111111111111111111