11111111111111111111111
1C000000100000111100001
1000000010000000010C001
1101110010111100C100001
1P0000000011C0000001101
11111111010111000000101
100001000000010000001C1
10C00100000001110111001
1101110010111000100C001
10000000000C000011001E1
11111111111111111111111