111111111
100100C01
1P00010E1
10010CC01
111111111