11111111111111111111
100100000111C0000001
11000P010C00001110E1
10000011000111C01001
11111111111111111111