11111111111
10P0000C001
10110001101
10101000101
10C00100E01
100C0111001
10000110C01
10100000111
11110001101
100C0010001
11111111111