111111111111111111111111111111111
100000000000000000000000000000001
101111111001000010001010111111101
101000001010101101110100100000101
101011101010111100100010101110101
101011101001010110111000101110101
101011101011100110011000101110101
101000001001110011100010100000101
101111111010101010101010111111101
100000000010100110101010000000001
101111101101111001000001101011001
101100100110010011111000001111101
100011011101011001100101100011001
100111010001101111101011011001001
100110001111100110011010010110001
101101100001100111111000011111001
100010001010001110101000000001001
100000010001101100110100000110101
100101011101100110000011001111101
101100010101011010011111010011101
101101001111110100001010111100001
100010110101000001110101100010001
100000111110101101010011111101101
100000000000010101101010001101001
101111111011011111100110101001001
101000001000111111000010001011001
1010111010101PCE00000011111110101
101011101010111000101000001010001
101011101011000010001000100010101
101000001010110100111101101001101
101111111011100110011101110010101
100000000000000000000000000000001
111111111111111111111111111111111