1111111111111111111111111111111
1000000011011110111010100000001
1011111010101001000101101111101
1010001010100001101110101000101
1010001011010100100011101000101
1010001010001100110011101000101
1011111011000110001110101111101
1000000010101010101010100000001
1111111110101100101010111111111
1000001001000011011111001010011
1001101100110110000011111000001
1110010001010011001101001110011
1100010111001000001010010011011
1100111000001100110010110100111
1001001111001100000011110000011
1110111010111000101011111111011
1111110111001001100101111100101
1101010001001100111110011000001
1001110101010010110000010110001
1001011000000101111010100001111
1110100101011111000101001110111
1111100000101001010110000001001
1111111111110101001010111001011
1000000010010000001100101011011
1011111011100PCE011110111010011
1010001010101111111110000000101
1010001010100011101011111010111
1010001010011110111011101110101
1011111010100101100001001011001
1000000010001100110001000110101
1111111111111111111111111111111