11111111111111111111111111
11111111111111111111111111
11111111111111111111111111
11000100P10001000010100011
11011101110101011110101011
1100010EC10101010010101011
11110101110011011010101011
11000100010101000010100011
11111111111111111111111111
11111111111111111111111111
11111111111111111111111111