NO ./texture/test/north_texture.png
SO ./texture/test/south_texture.png
WE ./texture/test/west_texture.png
EA ./texture/test/east_texture.png

F 5,5,5
C 1,1,

1111111111111111111111111
1000000000010000000000001
1000E10000100010000000001
1000100000000010000000001
1111110000000000000001111
1000000001010000000100001
1000000101010000000000001
1000000101000111110000001
1111000100000000000001111
1000000000000000000000001
1000000000000000000000001
1000000000001111000000001
1100000000000001011110001
1111000000000000000000001
1000000101000101010000001
1111000100000000000001111
1000000000000101010000001
1000000000000000000000001
1000000000000101010000001
1100000000000000000000001
1111000000000101010000001
1111111111111000001111111
1111111111111111111111111